00000000000000000000
00000000000000000000
00111100000000111100
00100000000000000100
00100000000000000100
00100000000000000100
00000000000000000000
00000000000000000000
00000000000000000000
00000000011000000000
00000000011000000000
00000000000000000000
00000000000000000000
00000000000000000000
00100000000000000100
00100000000000000100
00100000000000000100
00111100000000111100
00000000000000000000
00000000000000000000