00000000000000011111
00000000000000000001
00111000000000000001
00111000000000000001
00111000000000000001
00000000000000000000
00000000000000100000
00000000000000100000
00000000000000100000
00000000011111100000
00000000010000000000
00000000010000000000
00000000010000000000
00000000000000000000
00000000000000000000
10000000000000011100
10000000000000011100
10000000000000011100
10000000000000000000
11111000000000000000